.........
...2....1
.5.......
.....3...
.........
...1....
.........
.........
..5......